20 20
0 0 0 0 0 0 0 0 0 0 0 0 0 0 0 0 0 0 0 0 
0 6 6 6 6 6 6 6 6 6 6 6 6 6 6 6 6 6 6 0
0 9 1 1 1 1 1 1 1 1 1 1 1 1 1 1 1 1 8 0
0 9 1 1 1 1 1 1 1 1 1 1 1 1 1 1 1 1 8 0
0 9 1 1 1 1 1 1 1 1 1 1 1 1 1 1 1 1 8 0
0 9 1 7 7 7 1 7 7 7 1 7 7 7 1 1 1 1 8 0
0 9 8 2 2 2 5 2 2 2 5 2 2 2 9 1 1 1 8 0
0 9 8 2 2 2 5 2 2 2 5 2 2 2 9 1 1 1 8 0
0 9 8 2 2 2 5 2 2 2 5 2 2 2 9 1 1 1 8 0
0 9 8 2 2 2 5 2 2 2 5 2 2 2 9 1 1 1 8 0
0 9 8 2 2 2 5 2 2 2 5 2 2 2 9 1 1 1 8 0
0 9 8 2 2 2 5 2 2 2 5 2 2 2 9 1 1 1 8 0
0 9 8 2 2 2 5 2 2 2 5 2 2 2 9 1 1 1 8 0
0 9 8 2 2 2 5 2 2 2 5 2 2 2 9 1 1 1 8 0
0 9 1 6 6 6 1 6 6 6 1 6 6 6 1 1 1 1 8 0
0 9 1 1 1 1 1 1 1 1 1 1 1 1 1 1 1 1 8 0
0 9 1 1 1 1 1 1 1 1 1 1 1 1 1 1 1 1 8 0
0 9 1 1 1 1 1 1 1 1 1 1 1 1 1 1 1 1 8 0
0 7 7 7 7 7 7 7 7 7 7 7 7 7 7 7 7 7 7 0
0 0 0 0 0 0 0 0 0 0 0 0 0 0 0 0 0 0 0 0 